じんかつぼ	塵歌壺	固有名詞	
らいけつ	雷楔	固有名詞	
せいしんきい	星辰帰位	固有名詞	
こうてんのらいばつ	抵天の雷罰	固有名詞	
てんがいじゅんゆう	天街巡遊	固有名詞	
めいちょうのまい	冥蝶の舞	固有名詞	
むそうのいっしん	夢想の一心	固有名詞	
むそうのひとたち	夢想の一太刀	固有名詞	
むそうしんせつ	夢想真説	固有名詞	
あくようかいがん	悪曜開眼	固有名詞	
ぞうきんのはな	蔵金の花	固有名詞	
けいじのはな	啓示の花	固有名詞	
こくじゃきし	黒蛇騎士	人名	
しんぴこうふく	深秘降福	固有名詞	
しんきょうかいろう	深境回廊	固有名詞	
えんげつらせん	淵月螺旋	固有名詞	
えんげつのしゅくふく	淵月の祝福	固有名詞	
いせききへい	遺跡機兵	固有名詞	
てんくうきこう	天空紀行	固有名詞	
だいちきこう	大地紀行	固有名詞	
げんそきょうめい	元素共鳴	固有名詞	
ねっせいのほのお	熱誠の炎	固有名詞	
ちりょうのみず	治療の水	固有名詞	
じんそくのかぜ	迅速の風	固有名詞	
きょうけんのかみなり	強権の雷	固有名詞	
ふんさいのこおり	粉砕の氷	固有名詞	
ふどうのいわ	不動の岩	固有名詞	
こうさくのまもり	交錯の護り	固有名詞	
ふうかのしょうか	風花の頌歌	固有名詞	